14|0,7,4,10,0,0,0,0
15|0,0,0,0,5,7,0,0
16|0,0,0,6,8,5,0,0
17|0,0,0,0,0,9,0,10
18|0,0,0,7,0,0,7,0
19|0,0,0,4,0,3,0,8
20|0,0,0,0,0,0,11,8
21|0,0,0,0,0,0,0,0