22|0,5,6,0,15,0,0,0,0
23|5,0,0,2,0,0,0,0,0
24|6,0,0,0,7,1,0,0,0
25|0,2,0,0,10,0,3,0,0
26|15,0,7,10,0,3,0,7,4
27|0,0,1,0,3,0,0,9,0
28|0,0,0,3,0,0,0,2,8
29|0,0,0,0,7,9,2,0,1
30|0,0,0,0,4,0,8,1,0